50+ Works That Deserve to be Better Known
Facilitated by KenOC
Thread-contributors in parentheses

Granville Bantock - Celtic Symphony (Kivimees)
Granville Bantock - Fifine at the Fair (ShropshireMoose)
Arnold Bax - Symphony #3 (Pip)
Ludwig van Beethoven - Egmont, complete incidental music (Florestan)
Ernst Bloch - Concerto Grosso #1 (Weston)
Alexander Borodin - Symphony #1 in E flat major (Richannes Wrahms)
Havergal Brian - A Gothic Symphony (Headphone Hermit)
Benjamin Britten - Cello Symphony Op. 68 (KenOC)
William Byrd - The Battell, from My Ladye Nevvell's Booke (SimonNZ)
Joseph Canteloube - Suite "Dans la montagne" for violin and piano (BPS)
Alfredo Casella - Symphony #2 (GioCar)
Ernest Chausson - Symphony in B-flat major (senza sordino)
John Dowland - Semper Dowland semper dolens (Taggart)
William Duckworth - Time Curve Preludes (GreenMamba)
Guillaume Dufay - Missa L'homme arme (Chordalrock)
Gerald Finzi - Cello Concerto (Trout)
Howard Hanson - Symphony #3 (cournot)
Lou Harrison - Symphony #3 (Kevin Pearson)
Josef Mattias Hauer - Etudes (quack)
Bernard Herrmann - Symphony (Alfacharger)
Paul Hindemith - Ludus Tonalis (science)
Gustav Holst - A Fugal Concerto for flute, oboe, and string orchestra (Mister Man)
Arthur Honegger - Symphony #3 "Symphonie Liturgique" (Cosmos)
Johann Nepomuk Hummel - Piano Concerto No. 3 (mmsbls)
Vasily Kalinnikov - Symhony #2 (Radames)
Aram Khachaturian - Symphony #2 "The Bell" (techniquest)
Franz Liszt - Annees de pelerinage (SergeOfArniVillage)
Boris Lyatoshynsky - Symphony #3 (Rhombic)
Robert Moran - Requiem: Chant du Cygne (PetrB)
Joseph Marx - Quartetto Chromatico,1948 rev. (berlioznestpasmort)
Bohuslav Martinů - Symphony #2 (jim prideaux)
Jean-Joseph Cassanea de Mondonville - Cæli Enarrant (PrimoUomo)
Nikolai Myaskovsky - Symphony #9 in E minor (EdwardBast)
Luigi Nono - La Lontananza Nostalgica Utopica Futura (violadude)
Per Nørgård - Piano Concerto "In Due Tempi" (joen_cph)
Andrezj Panufnik - Sinfonia Sacra (MagneticGhost)
Walter Piston - Symphony #2 (arpeggio)
Max Reger - Eine romantische Suite Op. 125 (millionrainbows)
Anton Reicha - Wind Quintet Op. 100 #5 in A minor (Winterreisender)
Ferdinand Ries - Piano Concerto #8 in A-flat Major (kangxi)
Ned Rorem - Piano Sonata #2 (hreichgott)
Hans Rott - Symphony in E major (CyrilWashbrook)
Anton Rubinstein - Piano Concerto #3 Op. 45 (Tristan)
Franz Schmidt - Das Buch mit Sieben Siegeln (Xaltotun)
Franz Schmidt - Symphony #4 in C major (Mahlerian/hpowders)
Alfred Schnittke - Concerto Grosso #1 (Nereffid)
Richard Strauss - Parergon to the Sinfonia Domestica for piano l.h. and orch (moody)
Igor Stravinsky - Ebony Concerto (dgee)
Francisco Tarrega - the Little Musical Box (Ingélou)
Joaquin Turina - Piano Trio #1 Op. 35 (revdrdave)
William Walton - Variations on a Theme by Hindemith (Blancrocher)
Frank Zappa - The Little House I Used to Live In (BurningDesire)
Juliusz Zarębski - Piano Quintet in G minor (Aramis)